10000000000000000000000000000000
00000000000000000000000000000000
00000000000000000000000000000000
00000000000000660000000000000000
00000000000000000000000000000000
00000000000000000000000000000000
00000000000000000000000000000000
00000000000999999900000000000000
00000000000999999900000000000000
00000000000999999900000000000000
00000000000000000000000000000000
00000000000000006600000000000000
00000000000000000000000000000000
00000000000000000000000000000000
00000000000000000000000000000000
00000000000000000000000000000000
00000009999000000000000000000000
00000009999000000000000000000000
00000009999000006600000000000000
00000009999000000000000000000000
00000000000000000000000000000000
00000000000000000000000000000000
00000000000000000000000000000000
00000000000000999990000000000000
00000000000000999990000000000000
00000000000000999990000000000000
00000006600000000000000000000000
00000000000000000000000000000000
00000000000000000000000000000000
00000000000000000000000000000000
00000000000000000000000000000000
00000000000000000000000000000002